11111111111111111111
1C0000000000000000C1
11111100000000000001
10000010000000000001
10000001000000000001
1P0000001000000000E1
11111111111111111111
