11111111111111111111
1C0000000000000000C1
11111100000000000001
10000010000000000001
100000010000000000011111
1P0000001000000000E11111
11111111111111111111
