11111111111111111111
1P000000E000000000C1
11111111111111111111
