1111111111111111111111111111111111111111
1C00000000000000000000000000000000C100C1
100H0000000000000000100000000H0000010001
1000000000000000000010000000000000010001
1000000000000000000011111111111111110001
1000000000000000000000000000000000000001
10000111111110H0000000000000001111000001
1000000000001000000000000000001H01000001
1H000000000C1000000000000000001001000001
1111111111111000000C000000000010000000C1
1C00001000000000000000011111111111111111
111110100000000000000001C0000000000000C1
1000001000000000000000010000000000000001
1011111000000000000000010000000000000001
1000000000000000000000C100000H0000010001
1111110000000000001111110000000000010001
1000000000000000000000000000000000010001
1P00000000000000C000000000000000000100E1
1111111111111111111111111111111111111111
