1111111111111111111111111111111111111111
1C0000000000000000C11C0000000000000000C1
100000000000000000011C0000000000000000C1
100000000H00000000011C0000000000000000C1
100000000000000000011C0000000000000000C1
1P0000000000000000E11C0000000000000000C1
1000000000000000000000000000000000000001
1C0000000000000000C00C111111111111111111
1C0000000000000000C0000000000000000010C1
1C0000000H0000000000000000000000000010C1
1C00000000000000000000000000000000000001
1111111111111111111111111111111111111111
